%%%%%%%
%    .%
%. P..%
%     %
%%%%%%%